8 10
 9  5  3  9  1  3  9  5  5  7
10  9  4  6 10 10  8  5  1  7
10 12  1  3 10 10 10 11 12  3
12  5  6 12  6 12  6  8  5  6
 9  5  3  9  3  9  3  8  5  3
10  9  4  6 10 10 10 14  9  6
10 12  1  3 10 10  8  5  4  7
12  5  6 12  4  6 12  5  5  7
0 70

maze61

 _ _ _ _ _ _ _ _ _ _ 
|s _  |     |  _ _ _|
| |  _ _| | |  _   _|
| |_    | | | | |_  |
|_ _ _|_ _|_ _|  _ _|
|  _  |   |   |  _  |
| |  _ _| | | |_|  _|
| |_    | | |  _ _ _|
|g _ _|_ _ _|_ _ _ _|

