10 10

9    5    5    3    9    5    5    5    1    7    
10   9    5    6    10   13   1    3    10   11   
10   10   9    5    4    7    8    2    10   10   
10   10   10   11   11   13   6    10   10   10   
10   14   10   14   10   9    7    10   10   10   
8    5    4    5    6    8    5    6    10   10   
10   11   11   11   13   2    9    1    4    6    
10   12   4    0    5    2    12   0    5    3    
8    7    13   6    11   12   3    12   3    14   
12   7    13   5    4    5    4    7    12   7    

0 99

mymaze